1001110000
1101010011
1111010110
0011010101
0010010101
0111110101
0000110101
0011111111
0000010001
1111111111
