1001110000
1101010011
1111010110
0011010101
0010010101
0111110101
0000110101
0011111111
0000010001
1111111111
1101110011
1101010011
1111010110
0011010101
0010010101
0111110101
0000110101
1111111111
1000010001
1001111100
1000111111
1100010000
0110010110
0011010101
0010010101
1111110101
1000110101
1000011111
1000010001
1001110000
1001111100
1001010111
1011010110
1011010001
1110010101
0011110101
0010110101
1110011111
1000010001
1001111001
1111111111
1100110011
1000110001
1000110001
1111111111
1111111111
1000110001
1000110001
1100110011
1111111111